11111111
10100101
10101011
10101011
10101011
10101011
10101011
10101011