1111111111111111111111111
1000000000000000000000001
1010111111101111111011111
1010100000001000000010001
1010101110111111111011101
1010100010000000001000101
1010101111101110111010101
1010000000100000100010101
1011111110101110111011101
1000000010100000001000001
1110111010111111111011101
1000000010000000100000101
1110111010111010111011101
1000100010000010001010001
1111101010111110101111101
1000001010000010101000001
1010101010101010101010100
1010001000001000100000100
1111111111111111111111111