1111111111131111111111111
1000000000000000000000001
1010111111101111111011101
1010100000000000001010001
1010101111101111101111101
1010100000101000000000101
1010100011111010101110101
1010000010000010101000101
1011111010111011101010101
1000001010100000101000101
1011101011101110101111101
1010000010000010100000001
1010111111111010111111101
1000000000001010000000101
1011101111101111101110101
1010000000000000100010101
1011111110111011101011101
1000001000000000001010001
1011101111111110111010101
1000000000000000000000001
1111111111111211111111111
1111000011111211111111111
1111111111111211100111111
